I	m - म
you	timee - तिमी
he	u - उ
she	tini - तिनी
we	haamii - हामी
they	tineeharu - तिनीहरू
me	m - म
you	timee - तिमी
him	u - उ
her	unako - उनको
us	haamii - हामी
them	tineeharu - तिनीहरू
my	mero - मेरो
your	timro - तिम्रो
his	usko - उस्को
her	tinako - तिनको
our	haamro - हाम्रो
their	tineeharuko - तिनीहरूको
mine	mero - मेरो
yours	timro - तिम्रो
his	usko - उस्को
hers	unako - उनको
ours	haamro - हाम्रो
theirs	tineeharuko - तिनीहरूको